a contrario	ADV
a fortiori	ADV
a minima	ADV
a priori	ADV
ah bon	INTJ
ainsi de suite	ADV
ainsi que	CCONJ
alors que	SCONJ
aujourd' hui	ADV
à le jour le jour	ADV
à même	ADP
à même	ADJ
à tout le moins	ADV
à travers	ADP
à travers	ADV
bien que	SCONJ
bien sur	ADV
bien sûr	ADV
ce être - à - dire	CCONJ
de abord	ADV
de accord	ADV
de ailleurs	ADV
de après	ADP
de autant plus que	SCONJ
de autant plus	ADV
de autant que	SCONJ
de emblée	ADV
de facto	ADV
de même que	SCONJ
de même	ADV
de nouveau	ADV
de ores et déjà	ADV
de par	ADP
de sorte que	SCONJ
dès lors que	SCONJ
dès lors	ADV
eh bien	INTJ
en tant que	ADP
et puis	CCONJ
ex officio	ADV
globe trotter	NOUN
grâce à	ADP
grosso modo	ADV
horresco referens	ADV
hors pair	ADJ
in extremis	ADV
low cost	ADJ
ne importe quel	DET
ne importe qui	PRON
ne importe quoi	PRON
ou bien	CCONJ
parce que	SCONJ
petit à petit	ADV
pour de bon	ADV
quand bien même	SCONJ
quand même	ADV
quant à	ADP
quitte à	ADP
rien que	ADV
si bien que	SCONJ
statu quo	NOUN
suite à	ADP
tandis que	SCONJ
tel quel	ADJ
tout à fait	ADV
tout à le heure	ADV
tout de même	ADV
un petit peu	ADV
un peu	ADV